+++++++++++++++++++
+0A               +
+A             ++++
+                 +
+              ++A+
+               +a+
+++++++++++++++++++
